TTTTTTTTTTTTTTTTTTTTTTTTTTTTT
T    T                      T
T R  T                      T
T    T                      T
T                           T
T    T                      T
T    T                      T
TTTTTT                      T
T                           T
T                           T
T                           T
T                           T
T                           T
T                           T
T                           T
TTTTTTTTTTTTTTTTTTTTTTTTTTTTT